1111111111111
1P0000N000001
10111011101C1
1000N0000N001
101110C110101
100000N0000E1
1111111111111
