1111111
1P00XC1
10001E1
1111111
