1111111111
1P000111C1
1000111111
100E000001
1111111111
