1111111
1P00PC1
10001E1
1111111
