111111111111111
1P000000000C001
101110111011101
100000000000001
101110C11011101
100000000000E01
111111111111111
