1111111
1P0EC01
111E111
1111111
