1111111
1P0PC01
1111E11
1111111
