1111111
1P00001
1111E11
1111111
