1111111
1P00C01
1111111
1111111
