1111111
1P00001
1111E11
111C111
1111111
