1111111
100C001
1111E11
1111111
