1111111
0P00C01
0111E11
1111111
