0111111
1P00C01
1111E11
1111111
